1111111111111
11110000000C1
1C0C011111001
1P0011E000001
1111111111111
