1111111111111111111111111111111111
1P0000000000000C00000C000000000001
1010010100100000101001000000010101
1010010010101010001001000000010101
1010010010101010001001000000010101
1010010010101010001001000000010101
1010010010101010001001000000010101
1010010010101010001001000000010101
10100100101E1010001001000000010101
1010010010101010001001000000010101
1010010011101010001001000000010101
1010010010101010001001000000010101
1010010011101010001001000000010101
1010010010101010001001000000010101
1010010010101010001001000000010101
1010010010101010001001000000010101
100000001C00C0000000000000000000C1
1111111111111111111111111111111111
